1111111111111111111111111111111111111111111111111
10E000000000C00000000000000000000C000000000000001
100000000C000000000000000000000000000000011000001
1000000000000000000000000000000000000000110000001
10000000000000C0000000000000000C00000000000000001
1000111111111100000011111111100000011111111110001
1000111111111100000111111111110000011111111110001
1000000C00111000001110000000111000011000000000001
100000000111000001110000000001110001100C000000001
1000000011100000111000000000001110011000000000001
1000000111000000111000000000001110011111111110001
10000011100000C0111000000000001110011000000000001
10000111000000000111000000000111000110000C0000001
1000111000000000001110000000111000011000000000001
1000111111111100000111111111110000011111111110001
1000111111111100000011111111100000011111111110001
100000000000000000000000000000000C000000000000001
100C00000000000C000000000000000000000000000000001
100000000000000000000000000000000000000000000C001
1P00000000000000000000000000000000000000000000001
1111111111111111111111111111111111111111111111111
