11111111111111111111111111111111111111111111111111111111111111111111111111
100000000000C00000000000000000000C0000000000000000000000000000000000000001
10000000000000000000000000000000000000000110111110000000000000000000000001
1000000000000000000000000000000000000000011100000000C000000000000000000001
1000000000000000000000000000000C00000000001100000000000000000C000000000001
10001111111111000000111111111110000111111111111000000000111111111111110001
10001111111111000001111111111111000111111111111110000000111111111111110001
10001100000000000011100000000000000110000C00000000000000110000000000110001
100011000000000000111000C0000000000110000000000000000000000000000000110001
100011000C0000000001110000000000011111111111000111100000000000000000110001
10001100000000000000111000001111111111100000000111100000110000000000110001
10001100000111110000011100000000000110000000001111000000110000000000110001
10001100000011110000001110000000000110000000011110000000110000000000110001
10001111111111000000000111011111111111111111111100001111111100011111110001
100000000000000000111111111000C0000111111111111000000000111100011111110001
10000000000000000001111111110000000111111111111000000000110000000000110001
10001100000000000000000000111000000111111111111100000000110000000E00110001
10001100000000000000000000011100000110000000111100C00000110000000000110001
11111100000000000000000000001110000110000000011110000000110000000000110001
100011000000C0000000000000000111000110000000001111111111111100000000110001
10001100000000000000000000000111000110000000001111000000110000000000110001
100011000000000000000000000011100001100000C0001111000000110000000000110001
10001111111111000011111111111100000110000000001111000000110000000000110001
10001111111111000001111111111000000110000000001111000000110000000000110001
100000000000000000000000011000000C0000000000000000000000000000000000000001
1000000000C000000000000011100000000000000000000000000000000000000000000001
1000000000000000000000011111111111111111111000000000000000000C000000000001
10000000000000P00000000000000000000000000000000000000000000000000000000001
11111111111111111111111111111111111111111111111111111111111111111111111111
